a	determiner
abandon	verb
ability	noun
able	adjective
abolish	verb
abortion	noun
about	preposition
about	adverb
above	preposition
above	adverb
abroad	adverb
absence	noun
absent	adjective
absolute	adjective
absolutely	adverb
absorb	verb
abstract	adjective
absurd	adjective
abundance	noun
abuse	noun
abuse	verb
academic	adjective
academic	noun
academy	noun
accelerate	verb
accent	noun
accept	verb
acceptable	adjective
acceptance	noun
access	noun
access	verb
accessible	adjective
accident	noun
accidentally	adverb
accommodate	verb
accommodation	noun
accompany	verb
accomplish	verb
accomplishment	noun
accordance	noun
according to	preposition
accordingly	adverb
account	noun
account	verb
accountability	noun
accountable	adjective
accountant	noun
accounting	noun
accumulate	verb
accumulation	noun
accuracy	noun
accurate	adjective
accurately	adverb
accusation	noun
accuse	verb
accused	noun
achieve	verb
achievement	noun
acid	adjective
acid	noun
acknowledge	verb
acquire	verb
acquisition	noun
acre	noun
across	preposition
across	adverb
act	noun
act	verb
action	noun
activate	verb
activation	noun
active	adjective
activist	noun
activity	noun
actor	noun
actress	noun
actual	adjective
actually	adverb
acute	adjective
ad	noun
adapt	verb
adaptation	noun
add	verb
addiction	noun
addition	noun
additional	adjective
additionally	adverb
address	noun
address	verb
adequate	adjective
adequately	adverb
adhere	verb
adjacent	adjective
adjust	verb
adjustment	noun
administer	verb
administration	noun
administrative	adjective
administrator	noun
admire	verb
admission	noun
admit	verb
adolescent	noun
adopt	verb
adoption	noun
adult	adjective
adult	noun
advance	adjective
advance	noun
advance	verb
advanced	adjective
advantage	noun
adventure	noun
adverse	adjective
advertise	verb
advertisement	noun
advertising	noun
advice	noun
advise	verb
advocate	noun
advocate	verb
aesthetic	adjective
affair	noun
affect	verb
affection	noun
afford	verb
affordable	adjective
afraid	adjective
after	conjunction
after	preposition
after	adverb
aftermath	noun
afternoon	noun
afterwards	adverb
again	adverb
against	preposition
age	noun
age	verb
aged	adjective
agency	noun
agenda	noun
agent	noun
aggression	noun
aggressive	adjective
ago	adverb
agree	verb
agreement	noun
agricultural	adjective
agriculture	noun
ah	exclamation
ahead	adverb
aid	noun
aid	verb
aide	noun
AIDS	noun
aim	noun
aim	verb
air	noun
aircraft	noun
airline	noun
airport	noun
alarm	noun
alarm	verb
albeit	conjunction
album	noun
alcohol	noun
alcoholic	adjective
alert	adjective
alert	noun
alert	verb
alien	adjective
alien	noun
align	verb
alignment	noun
alike	adjective
alike	adverb
alive	adjective
all	determiner
all	pronoun
all	adverb
all right	adjective
all right	adverb
all right	exclamation
allegation	noun
allege	verb
allegedly	adverb
alliance	noun
allocate	verb
allocation	noun
allow	verb
allowance	noun
ally	noun
almost	adverb
alone	adjective
alone	adverb
along	preposition
along	adverb
alongside	preposition
already	adverb
also	adverb
alter	verb
alternative	adjective
alternative	noun
although	conjunction
altogether	adverb
aluminium	noun
always	adverb
amateur	adjective
amateur	noun
amazed	adjective
amazing	adjective
ambassador	noun
ambition	noun
ambitious	adjective
ambulance	noun
amend	verb
amendment	noun
amid	preposition
among	preposition
amount	noun
amount	verb
amusing	adjective
analogy	noun
analyse	verb
analysis	noun
analyst	noun
ancestor	noun
anchor	noun
ancient	adjective
and	conjunction
angel	noun
anger	noun
angle	noun
angrily	adverb
angry	adjective
animal	noun
animation	noun
ankle	noun
anniversary	noun
announce	verb
announcement	noun
annoy	verb
annoyed	adjective
annoying	adjective
annual	adjective
annually	adverb
anonymous	adjective
another	determiner
another	pronoun
answer	noun
answer	verb
anticipate	verb
anxiety	noun
anxious	adjective
any	determiner
any	pronoun
any	adverb
any more	adverb
anybody	pronoun
anyone	pronoun
anything	pronoun
anyway	adverb
anywhere	pronoun
anywhere	adverb
apart	adverb
apartment	noun
apologize	verb
apology	noun
app	noun
apparatus	noun
apparent	adjective
apparently	adverb
appeal	noun
appeal	verb
appealing	adjective
appear	verb
appearance	noun
appetite	noun
applaud	verb
apple	noun
applicable	adjective
applicant	noun
application	noun
apply	verb
appoint	verb
appointment	noun
appreciate	verb
appreciation	noun
approach	noun
approach	verb
appropriate	adjective
appropriately	adverb
approval	noun
approve	verb
approximately	adverb
April	noun
arbitrary	adjective
architect	noun
architectural	adjective
architecture	noun
archive	noun
area	noun
arena	noun
arguably	adverb
argue	verb
argument	noun
arise	verb
arm	noun
arm	verb
armed	adjective
arms	noun
army	noun
around	preposition
around	adverb
arrange	verb
arrangement	noun
array	noun
arrest	noun
arrest	verb
arrival	noun
arrive	verb
arrow	noun
art	noun
article	noun
articulate	verb
artificial	adjective
artist	noun
artistic	adjective
artwork	noun
as	conjunction
as	preposition
as	adverb
ash	noun
ashamed	adjective
aside	adverb
ask	verb
asleep	adjective
aspect	noun
aspiration	noun
aspire	verb
assassination	noun
assault	noun
assault	verb
assemble	verb
assembly	noun
assert	verb
assertion	noun
assess	verb
assessment	noun
asset	noun
assign	verb
assignment	noun
assist	verb
assistance	noun
assistant	noun
assistant	adjective
associate	verb
associated	adjective
association	noun
assume	verb
assumption	noun
assurance	noun
assure	verb
astonishing	adjective
asylum	noun
at	preposition
athlete	noun
atmosphere	noun
atrocity	noun
attach	verb
attachment	noun
attack	noun
attack	verb
attain	verb
attempt	noun
attempt	verb
attend	verb
attendance	noun
attention	noun
attention	exclamation
attitude	noun
attorney	noun
attract	verb
attraction	noun
attractive	adjective
attribute	noun
attribute	verb
auction	noun
audience	noun
audio	adjective
audit	noun
August	noun
aunt	noun
authentic	adjective
author	noun
authority	noun
authorize	verb
auto	noun
automatic	adjective
automatically	adverb
autonomy	noun
autumn	noun
availability	noun
available	adjective
average	adjective
average	noun
average	verb
avoid	verb
await	verb
award	noun
award	verb
aware	adjective
awareness	noun
away	adverb
awful	adjective
awkward	adjective
baby	noun
back	adjective
back	noun
back	adverb
back	verb
backdrop	noun
background	noun
backing	noun
backup	noun
backwards	adverb
bacteria	noun
bad	adjective
badge	noun
badly	adverb
bag	noun
bail	noun
bake	verb
balance	noun
balance	verb
balanced	adjective
ball	noun
ballet	noun
balloon	noun
ballot	noun
ban	noun
ban	verb
banana	noun
band	noun
bank	noun
banner	noun
bar	noun
bar	verb
bare	adjective
barely	adverb
bargain	noun
barrel	noun
barrier	noun
base	noun
base	verb
baseball	noun
based	adjective
basement	noun
basic	adjective
basically	adverb
basis	noun
basket	noun
basketball	noun
bass	noun
bat	noun
bat	verb
bath	noun
bathroom	noun
battery	noun
battle	noun
battle	verb
battlefield	noun
bay	noun
be	verb
be	auxiliary verb
beach	noun
beam	noun
bean	noun
bear	noun
bear	verb
beast	noun
beat	noun
beat	verb
beautiful	adjective
beauty	noun
because	conjunction
become	verb
bed	noun
bedroom	noun
bee	noun
beef	noun
beer	noun
before	conjunction
before	preposition
before	adverb
beg	verb
begin	verb
beginning	noun
behalf	noun
behave	verb
behaviour	noun
behind	preposition
behind	adverb
being	noun
belief	noun
believe	verb
bell	noun
belong	verb
beloved	adjective
below	preposition
below	adverb
belt	noun
bench	noun
benchmark	noun
bend	noun
bend	verb
beneath	preposition
beneficial	adjective
beneficiary	noun
benefit	noun
benefit	verb
bent	adjective
beside	preposition
besides	preposition
besides	adverb
best	adjective
best	noun
best	adverb
bet	noun
bet	verb
betray	verb
better	adjective
better	noun
better	adverb
between	preposition
between	adverb
beyond	preposition
beyond	adverb
bias	noun
bicycle	noun
bid	noun
bid	verb
big	adjective
bike	noun
bill	noun
bill	verb
billion	number
bin	noun
bind	verb
biography	noun
biological	adjective
biology	noun
bird	noun
birth	noun
birthday	noun
biscuit	noun
bishop	noun
bit	noun
bite	noun
bite	verb
bitter	adjective
bizarre	adjective
black	adjective
black	noun
blade	noun
blame	noun
blame	verb
blank	adjective
blank	noun
blanket	noun
blast	noun
blast	verb
bleed	verb
blend	verb
bless	verb
blessing	noun
blind	adjective
block	noun
block	verb
blog	noun
blonde	adjective
blood	noun
blow	noun
blow	verb
blue	adjective
blue	noun
board	noun
board	verb
boast	verb
boat	noun
body	noun
boil	verb
bold	adjective
bomb	noun
bomb	verb
bombing	noun
bond	noun
bone	noun
bonus	noun
book	noun
book	verb
booking	noun
boom	noun
boost	noun
boost	verb
boot	noun
border	noun
border	verb
bored	adjective
boring	adjective
born	verb
borrow	verb
boss	noun
both	determiner
both	pronoun
bother	verb
bottle	noun
bottom	adjective
bottom	noun
bounce	verb
bound	adjective
boundary	noun
bow	noun
bow	verb
bowl	noun
box	noun
boy	noun
boyfriend	noun
brain	noun
branch	noun
brand	noun
brand	verb
brave	adjective
breach	noun
breach	verb
bread	noun
break	noun
break	verb
breakdown	noun
breakfast	noun
breakthrough	noun
breast	noun
breath	noun
breathe	verb
breathing	noun
breed	noun
breed	verb
brick	noun
bride	noun
bridge	noun
brief	adjective
briefly	adverb
bright	adjective
brilliant	adjective
bring	verb
broad	adjective
broadband	noun
broadcast	noun
broadcast	verb
broadcaster	noun
broadly	adverb
broken	adjective
brother	noun
brown	adjective
brown	noun
browser	noun
brush	noun
brush	verb
brutal	adjective
bubble	noun
buck	noun
buddy	noun
budget	noun
buffer	noun
bug	noun
build	verb
building	noun
bulk	noun
bullet	noun
bunch	noun
burden	noun
bureaucracy	noun
burial	noun
burn	noun
burn	verb
burst	verb
bury	verb
bus	noun
bush	noun
business	noun
businessman	noun
busy	adjective
but	conjunction
but	preposition
butter	noun
button	noun
buy	verb
by	preposition
by	adverb
bye	exclamation
cabin	noun
cabinet	noun
cable	noun
cafe	noun
cake	noun
calculate	verb
calculation	noun
call	noun
call	verb
calm	adjective
calm	noun
calm	verb
camera	noun
camp	noun
camp	verb
campaign	noun
campaign	verb
camping	noun
campus	noun
can	modal verb
can	noun
canal	noun
cancel	verb
cancer	noun
candidate	noun
candle	noun
cannot	verb
canvas	noun
cap	noun
capability	noun
capable	adjective
capacity	noun
capital	adjective
capital	noun
capitalism	noun
capitalist	adjective
captain	noun
capture	noun
capture	verb
car	noun
carbon	noun
card	noun
care	noun
care	verb
career	noun
careful	adjective
carefully	adverb
careless	adjective
cargo	noun
carpet	noun
carriage	noun
carrot	noun
carry	verb
cartoon	noun
carve	verb
case	noun
cash	noun
casino	noun
cast	noun
cast	verb
castle	noun
casual	adjective
casualty	noun
cat	noun
catalogue	noun
catch	noun
catch	verb
category	noun
cater	verb
cattle	noun
cause	noun
cause	verb
caution	noun
cautious	adjective
cave	noun
CD	noun
cease	verb
ceiling	noun
celebrate	verb
celebration	noun
celebrity	noun
cell	noun
cemetery	noun
cent	noun
central	adjective
centre	noun
centre	verb
century	noun
ceremony	noun
certain	adjective
certainly	adverb
certainty	noun
certificate	noun
chain	noun
chain	verb
chair	noun
chair	verb
chairman	noun
challenge	noun
challenge	verb
challenging	adjective
chamber	noun
champion	noun
championship	noun
chance	noun
change	noun
change	verb
channel	noun
chaos	noun
chapter	noun
character	noun
characteristic	adjective
characteristic	noun
characterize	verb
charge	noun
charge	verb
charity	noun
charm	noun
charming	adjective
chart	noun
chart	verb
charter	noun
chase	noun
chase	verb
chat	noun
chat	verb
cheap	adjective
cheap	adverb
cheat	noun
cheat	verb
check	noun
check	verb
cheek	noun
cheer	noun
cheer	verb
cheerful	adjective
cheese	noun
chef	noun
chemical	adjective
chemical	noun
chemistry	noun
chest	noun
chicken	noun
chief	adjective
chief	noun
child	noun
childhood	noun
chip	noun
chocolate	noun
choice	noun
choir	noun
choose	verb
chop	verb
chronic	adjective
chunk	noun
church	noun
cigarette	noun
cinema	noun
circle	noun
circle	verb
circuit	noun
circulate	verb
circulation	noun
circumstance	noun
cite	verb
citizen	noun
citizenship	noun
city	noun
civic	adjective
civil	adjective
civilian	adjective
civilian	noun
civilization	noun
claim	noun
claim	verb
clarify	verb
clarity	noun
clash	noun
class	noun
classic	adjective
classic	noun
classical	adjective
classification	noun
classify	verb
classroom	noun
clause	noun
clean	adjective
clean	verb
cleaning	noun
clear	adjective
clear	verb
clearly	adverb
clerk	noun
clever	adjective
click	noun
click	verb
client	noun
cliff	noun
climate	noun
climb	noun
climb	verb
cling	verb
clinic	noun
clinical	adjective
clip	noun
clock	noun
close	adjective
close	noun
close	adverb
close	verb
closed	adjective
closely	adverb
closure	noun
cloth	noun
clothes	noun
clothing	noun
cloud	noun
club	noun
clue	noun
cluster	noun
coach	noun
coach	verb
coal	noun
coalition	noun
coast	noun
coastal	adjective
coat	noun
cocktail	noun
code	noun
coffee	noun
cognitive	adjective
coin	noun
coincide	verb
coincidence	noun
cold	adjective
cold	noun
collaborate	verb
collaboration	noun
collapse	noun
collapse	verb
colleague	noun
collect	verb
collection	noun
collective	adjective
collector	noun
college	noun
collision	noun
colonial	adjective
colony	noun
colour	noun
coloured	adjective
colourful	adjective
column	noun
columnist	noun
combat	noun
combat	verb
combination	noun
combine	verb
come	verb
comedy	noun
comfort	noun
comfort	verb
comfortable	adjective
comic	adjective
comic	noun
command	noun
command	verb
commander	noun
commence	verb
comment	noun
comment	verb
commentary	noun
commentator	noun
commerce	noun
commercial	adjective
commercial	noun
commission	noun
commission	verb
commissioner	noun
commit	verb
commitment	noun
committee	noun
commodity	noun
common	adjective
commonly	adverb
communicate	verb
communication	noun
communist	adjective
community	noun
companion	noun
company	noun
comparable	adjective
comparative	adjective
compare	verb
comparison	noun
compassion	noun
compel	verb
compelling	adjective
compensate	verb
compensation	noun
compete	verb
competence	noun
competent	adjective
competition	noun
competitive	adjective
competitor	noun
compile	verb
complain	verb
complaint	noun
complement	verb
complete	adjective
complete	verb
completely	adverb
completion	noun
complex	adjective
complex	noun
complexity	noun
compliance	noun
complicated	adjective
complication	noun
comply	verb
component	noun
compose	verb
composer	noun
composition	noun
compound	noun
comprehensive	adjective
comprise	verb
compromise	noun
compromise	verb
compulsory	adjective
compute	verb
computer	noun
conceal	verb
concede	verb
conceive	verb
concentrate	verb
concentration	noun
concept	noun
conception	noun
concern	noun
concern	verb
concerned	adjective
concert	noun
concession	noun
conclude	verb
conclusion	noun
concrete	adjective
concrete	noun
condemn	verb
condition	noun
conduct	noun
conduct	verb
confer	verb
conference	noun
confess	verb
confession	noun
confidence	noun
confident	adjective
configuration	noun
confine	verb
confirm	verb
confirmation	noun
conflict	noun
conflict	verb
confront	verb
confrontation	noun
confuse	verb
confused	adjective
confusing	adjective
confusion	noun
congratulate	verb
congregation	noun
congressional	adjective
connect	verb
connected	adjective
connection	noun
conquer	verb
conscience	noun
conscious	adjective
consciousness	noun
consecutive	adjective
consensus	noun
consent	noun
consequence	noun
consequently	adverb
conservation	noun
conservative	adjective
conservative	noun
conserve	verb
consider	verb
considerable	adjective
considerably	adverb
consideration	noun
consist	verb
consistency	noun
consistent	adjective
consistently	adverb
consolidate	verb
conspiracy	noun
constant	adjective
constantly	adverb
constituency	noun
constitute	verb
constitution	noun
constitutional	adjective
constraint	noun
construct	verb
construction	noun
consult	verb
consultant	noun
consultation	noun
consume	verb
consumer	noun
consumption	noun
contact	noun
contact	verb
contain	verb
container	noun
contemplate	verb
contemporary	adjective
contempt	noun
contend	verb
contender	noun
content	adjective
content	noun
contention	noun
contest	noun
contest	verb
context	noun
continent	noun
continually	adverb
continue	verb
continuous	adjective
contract	noun
contract	verb
contractor	noun
contradiction	noun
contrary	adjective
contrary	noun
contrast	noun
contrast	verb
contribute	verb
contribution	noun
contributor	noun
control	noun
control	verb
controversial	adjective
controversy	noun
convenience	noun
convenient	adjective
convention	noun
conventional	adjective
conversation	noun
conversion	noun
convert	verb
convey	verb
convict	verb
conviction	noun
convince	verb
convinced	adjective
convincing	adjective
cook	noun
cook	verb
cooker	noun
cooking	noun
cool	adjective
cool	verb
cooperate	verb
cooperative	adjective
coordinate	verb
coordination	noun
coordinator	noun
cop	noun
cope	verb
copper	noun
copy	noun
copy	verb
copyright	noun
core	noun
core	adjective
corner	noun
corporate	adjective
corporation	noun
correct	adjective
correct	verb
correction	noun
correctly	adverb
correlate	verb
correlation	noun
correspond	verb
correspondence	noun
correspondent	noun
corresponding	adjective
corridor	noun
corrupt	adjective
corruption	noun
cost	noun
cost	verb
costly	adjective
costume	noun
cottage	noun
cotton	noun
could	modal verb
council	noun
councillor	noun
counselling	noun
counsellor	noun
count	noun
count	verb
counter	noun
counter	verb
counterpart	noun
countless	adjective
country	noun
countryside	noun
county	noun
coup	noun
couple	noun
courage	noun
course	noun
court	noun
courtesy	noun
cousin	noun
cover	noun
cover	verb
coverage	noun
covered	adjective
cow	noun
crack	noun
crack	verb
craft	noun
craft	verb
crash	noun
crash	verb
crawl	verb
crazy	adjective
cream	noun
cream	adjective
create	verb
creation	noun
creative	adjective
creativity	noun
creator	noun
creature	noun
credibility	noun
credible	adjective
credit	noun
credit	verb
creep	verb
crew	noun
crime	noun
criminal	adjective
criminal	noun
crisis	noun
criterion	noun
critic	noun
critical	adjective
critically	adverb
criticism	noun
criticize	verb
critique	noun
crop	noun
cross	noun
cross	verb
crowd	noun
crowded	adjective
crown	noun
crucial	adjective
crude	adjective
cruel	adjective
cruise	noun
crush	verb
cry	noun
cry	verb
crystal	noun
cue	noun
cult	noun
cult	adjective
cultivate	verb
cultural	adjective
culture	noun
cup	noun
cupboard	noun
cure	noun
cure	verb
curiosity	noun
curious	adjective
curly	adjective
currency	noun
current	adjective
current	noun
currently	adverb
curriculum	noun
curtain	noun
curve	noun
curve	verb
curved	adjective
custody	noun
custom	noun
customer	noun
cut	noun
cut	verb
cute	adjective
cutting	noun
cycle	noun
cycle	verb
cynical	adjective
dad	noun
daily	adjective
daily	adverb
dairy	adjective
dairy	noun
dam	noun
damage	noun
damage	verb
damaging	adjective
dance	noun
dance	verb
dancer	noun
dancing	noun
danger	noun
dangerous	adjective
dare	verb
dark	adjective
dark	noun
darkness	noun
data	noun
database	noun
date	noun
date	verb
daughter	noun
dawn	noun
day	noun
dead	adjective
deadline	noun
deadly	adjective
deal	noun
deal	verb
dealer	noun
dear	adjective
dear	exclamation
death	noun
debate	noun
debate	verb
debris	noun
debt	noun
debut	noun
decade	noun
December	noun
decent	adjective
decide	verb
decision	noun
decision-making	noun
decisive	adjective
deck	noun
declaration	noun
declare	verb
decline	noun
decline	verb
decorate	verb
decoration	noun
decrease	noun
decrease	verb
dedicated	adjective
dedication	noun
deed	noun
deem	verb
deep	adjective
deep	adverb
deeply	adverb
default	noun
defeat	noun
defeat	verb
defect	noun
defence	noun
defend	verb
defender	noun
defensive	adjective
deficiency	noun
deficit	noun
define	verb
definite	adjective
definitely	adverb
definition	noun
defy	verb
degree	noun
delay	noun
delay	verb
delegate	noun
delegation	noun
delete	verb
deliberate	adjective
deliberately	adverb
delicate	adjective
delicious	adjective
delight	noun
delight	verb
delighted	adjective
deliver	verb
delivery	noun
demand	noun
demand	verb
democracy	noun
democratic	adjective
demon	noun
demonstrate	verb
demonstration	noun
denial	noun
denounce	verb
dense	adjective
density	noun
dentist	noun
deny	verb
depart	verb
department	noun
departure	noun
depend	verb
dependence	noun
dependent	adjective
depict	verb
deploy	verb
deployment	noun
deposit	noun
deposit	verb
depressed	adjective
depressing	adjective
depression	noun
deprive	verb
depth	noun
deputy	noun
derive	verb
descend	verb
descent	noun
describe	verb
description	noun
desert	noun
desert	verb
deserve	verb
design	noun
design	verb
designate	verb
designer	noun
desirable	adjective
desire	noun
desire	verb
desk	noun
desktop	noun
desperate	adjective
desperately	adverb
despite	preposition
destination	noun
destroy	verb
destruction	noun
destructive	adjective
detail	noun
detail	verb
detailed	adjective
detain	verb
detect	verb
detection	noun
detective	noun
detention	noun
deteriorate	verb
determination	noun
determine	verb
determined	adjective
devastate	verb
develop	verb
development	noun
device	noun
devil	noun
devise	verb
devote	verb
diagnose	verb
diagnosis	noun
diagram	noun
dialogue	noun
diamond	noun
diary	noun
dictate	verb
dictator	noun
dictionary	noun
die	verb
diet	noun
differ	verb
difference	noun
different	adjective
differentiate	verb
differently	adverb
difficult	adjective
difficulty	noun
dig	verb
digital	adjective
dignity	noun
dilemma	noun
dimension	noun
diminish	verb
dinner	noun
dip	verb
diplomat	noun
diplomatic	adjective
direct	adjective
direct	adverb
direct	verb
direction	noun
directly	adverb
director	noun
directory	noun
dirt	noun
dirty	adjective
disability	noun
disabled	adjective
disadvantage	noun
disagree	verb
disagreement	noun
disappear	verb
disappoint	verb
disappointed	adjective
disappointing	adjective
disappointment	noun
disaster	noun
disastrous	adjective
disc	noun
discard	verb
discharge	verb
discipline	noun
disclose	verb
disclosure	noun
discount	noun
discount	verb
discourage	verb
discourse	noun
discover	verb
discovery	noun
discretion	noun
discrimination	noun
discuss	verb
discussion	noun
disease	noun
dish	noun
dishonest	adjective
dislike	noun
dislike	verb
dismiss	verb
dismissal	noun
disorder	noun
displace	verb
display	noun
display	verb
disposal	noun
dispose	verb
dispute	noun
dispute	verb
disrupt	verb
disruption	noun
dissolve	verb
distance	noun
distant	adjective
distinct	adjective
distinction	noun
distinctive	adjective
distinguish	verb
distort	verb
distract	verb
distress	noun
distribute	verb
distribution	noun
district	noun
disturb	verb
disturbing	adjective
dive	noun
dive	verb
diverse	adjective
diversity	noun
divert	verb
divide	noun
divide	verb
divine	adjective
division	noun
divorce	noun
divorce	verb
divorced	adjective
do	verb
do	auxiliary verb
doctor	noun
doctrine	noun
document	noun
document	verb
documentary	noun
documentation	noun
dog	noun
dollar	noun
domain	noun
domestic	adjective
dominance	noun
dominant	adjective
dominate	verb
donate	verb
donation	noun
donor	noun
door	noun
dose	noun
dot	noun
double	determiner
double	adjective
double	pronoun
double	adverb
double	verb
doubt	noun
doubt	verb
down	preposition
down	adverb
download	noun
download	verb
downstairs	adjective
downstairs	adverb
downtown	adjective
downtown	noun
downtown	adverb
downwards	adverb
dozen	noun
dozen	determiner
draft	noun
draft	verb
drag	verb
drain	verb
drama	noun
dramatic	adjective
dramatically	adverb
draw	verb
drawing	noun
dream	noun
dream	verb
dress	noun
dress	verb
dressed	adjective
drift	verb
drink	noun
drink	verb
drive	noun
drive	verb
driver	noun
driving	adjective
driving	noun
drop	noun
drop	verb
drought	noun
drown	verb
drug	noun
drum	noun
drunk	adjective
dry	adjective
dry	verb
dual	adjective
dub	verb
due	adjective
dull	adjective
dumb	adjective
dump	verb
duo	noun
duration	noun
during	preposition
dust	noun
duty	noun
DVD	noun
dynamic	adjective
dynamic	noun
each	determiner
each	pronoun
each	adverb
eager	adjective
ear	noun
early	adjective
early	adverb
earn	verb
earnings	noun
earth	noun
earthquake	noun
ease	noun
ease	verb
easily	adverb
east	adjective
east	noun
east	adverb
eastern	adjective
easy	adjective
eat	verb
echo	verb
ecological	adjective
economic	adjective
economics	noun
economist	noun
economy	noun
edge	noun
edit	verb
edition	noun
editor	noun
editorial	adjective
educate	verb
educated	adjective
education	noun
educational	adjective
educator	noun
effect	noun
effective	adjective
effectively	adverb
effectiveness	noun
efficiency	noun
efficient	adjective
efficiently	adverb
effort	noun
egg	noun
ego	noun
eight	number
eighteen	number
eighty	number
either	determiner
either	pronoun
either	adverb
elaborate	adjective
elbow	noun
elderly	adjective
elect	verb
election	noun
electoral	adjective
electric	adjective
electrical	adjective
electricity	noun
electronic	adjective
electronics	noun
elegant	adjective
element	noun
elementary	adjective
elephant	noun
elevate	verb
eleven	number
eligible	adjective
eliminate	verb
elite	noun
else	adverb
elsewhere	adverb
email	noun
email	verb
embark	verb
embarrassed	adjective
embarrassing	adjective
embarrassment	noun
embassy	noun
embed	verb
embody	verb
embrace	verb
emerge	verb
emergence	noun
emergency	noun
emission	noun
emotion	noun
emotional	adjective
emotionally	adverb
emphasis	noun
emphasize	verb
empire	noun
empirical	adjective
employ	verb
employee	noun
employer	noun
employment	noun
empower	verb
empty	adjective
empty	verb
enable	verb
enact	verb
encompass	verb
encounter	noun
encounter	verb
encourage	verb
encouragement	noun
encouraging	adjective
end	noun
end	verb
endeavour	noun
ending	noun
endless	adjective
endorse	verb
endorsement	noun
endure	verb
enemy	noun
energy	noun
enforce	verb
enforcement	noun
engage	verb
engaged	adjective
engagement	noun
engaging	adjective
engine	noun
engineer	noun
engineering	noun
enhance	verb
enjoy	verb
enjoyable	adjective
enormous	adjective
enough	determiner
enough	pronoun
enough	adverb
enquire	verb
enquiry	noun
enrich	verb
enrol	verb
ensue	verb
ensure	verb
enter	verb
enterprise	noun
entertain	verb
entertaining	adjective
entertainment	noun
enthusiasm	noun
enthusiast	noun
enthusiastic	adjective
entire	adjective
entirely	adverb
entitle	verb
entity	noun
entrance	noun
entrepreneur	noun
entry	noun
envelope	noun
environment	noun
environmental	adjective
epidemic	noun
episode	noun
equal	adjective
equal	noun
equal	verb
equality	noun
equally	adverb
equation	noun
equip	verb
equipment	noun
equivalent	adjective
equivalent	noun
era	noun
erect	verb
error	noun
erupt	verb
escalate	verb
escape	noun
escape	verb
especially	adverb
essay	noun
essence	noun
essential	adjective
essentially	adverb
establish	verb
establishment	noun
estate	noun
estimate	noun
estimate	verb
eternal	adjective
ethic	noun
ethical	adjective
ethnic	adjective
euro	noun
evacuate	verb
evaluate	verb
evaluation	noun
even	adjective
even	adverb
evening	noun
event	noun
eventually	adverb
ever	adverb
every	determiner
everybody	pronoun
everyday	adjective
everyone	pronoun
everything	pronoun
everywhere	adverb
evidence	noun
evident	adjective
evil	adjective
evil	noun
evoke	verb
evolution	noun
evolutionary	adjective
evolve	verb
exact	adjective
exactly	adverb
exaggerate	verb
exam	noun
examination	noun
examine	verb
example	noun
exceed	verb
excellence	noun
excellent	adjective
except	conjunction
except	preposition
exception	noun
exceptional	adjective
excess	adjective
excess	noun
excessive	adjective
exchange	noun
exchange	verb
excited	adjective
excitement	noun
exciting	adjective
exclude	verb
exclusion	noun
exclusive	adjective
exclusively	adverb
excuse	noun
excuse	verb
execute	verb
execution	noun
executive	adjective
executive	noun
exercise	noun
exercise	verb
exert	verb
exhibit	noun
exhibit	verb
exhibition	noun
exile	noun
exist	verb
existence	noun
exit	noun
exotic	adjective
expand	verb
expansion	noun
expect	verb
expectation	noun
expected	adjective
expedition	noun
expenditure	noun
expense	noun
expensive	adjective
experience	noun
experience	verb
experienced	adjective
experiment	noun
experiment	verb
experimental	adjective
expert	adjective
expert	noun
expertise	noun
expire	verb
explain	verb
explanation	noun
explicit	adjective
explicitly	adverb
explode	verb
exploit	verb
exploitation	noun
exploration	noun
explore	verb
explosion	noun
explosive	adjective
explosive	noun
export	noun
export	verb
expose	verb
exposure	noun
express	verb
expression	noun
extend	verb
extension	noun
extensive	adjective
extensively	adverb
extent	noun
external	adjective
extra	adjective
extra	noun
extra	adverb
extract	noun
extract	verb
extraordinary	adjective
extreme	adjective
extreme	noun
extremely	adverb
extremist	noun
eye	noun
fabric	noun
fabulous	adjective
face	noun
face	verb
facilitate	verb
facility	noun
fact	noun
faction	noun
factor	noun
factory	noun
faculty	noun
fade	verb
fail	verb
failed	adjective
failure	noun
fair	adjective
fairly	adverb
fairness	noun
faith	noun
fake	adjective
fall	noun
fall	verb
false	adjective
fame	noun
familiar	adjective
family	adjective
family	noun
famous	adjective
fan	noun
fancy	adjective
fancy	verb
fantastic	adjective
fantasy	noun
far	adjective
far	adverb
fare	noun
farm	noun
farm	verb
farmer	noun
farming	noun
fascinating	adjective
fashion	noun
fashionable	adjective
fast	adjective
fast	adverb
fasten	verb
fat	adjective
fat	noun
fatal	adjective
fate	noun
father	noun
fault	noun
favour	noun
favour	verb
favourable	adjective
favourite	adjective
favourite	noun
fear	noun
fear	verb
feat	noun
feather	noun
feature	noun
feature	verb
February	noun
federal	adjective
fee	noun
feed	noun
feed	verb
feedback	noun
feeding	noun
feel	noun
feel	verb
feeling	noun
fellow	adjective
female	adjective
female	noun
feminist	adjective
fence	noun
festival	noun
fever	noun
few	determiner
few	adjective
few	pronoun
fibre	noun
fiction	noun
field	noun
fierce	adjective
fifteen	number
fifth	ordinal number
fifty	number
fight	noun
fight	verb
fighting	noun
figure	noun
figure	verb
file	noun
file	verb
fill	verb
film	noun
film	verb
film-maker	noun
filter	noun
filter	verb
final	adjective
final	noun
finally	adverb
finance	noun
finance	verb
financial	adjective
find	verb
finding	noun
fine	adjective
fine	noun
finger	noun
finish	noun
finish	verb
fire	noun
fire	verb
firearm	noun
firefighter	noun
firework	noun
firm	adjective
firm	noun
firmly	adverb
first	noun
first	adverb
first	determiner
first	number
firstly	adverb
fish	noun
fish	verb
fishing	noun
fit	adjective
fit	noun
fit	verb
fitness	noun
five	number
fix	noun
fix	verb
fixed	adjective
fixture	noun
flag	noun
flame	noun
flash	noun
flash	verb
flat	adjective
flat	noun
flavour	noun
flaw	noun
flawed	adjective
flee	verb
fleet	noun
flesh	noun
flexibility	noun
flexible	adjective
flight	noun
float	verb
flood	noun
flood	verb
floor	noun
flour	noun
flourish	verb
flow	noun
flow	verb
flower	noun
flu	noun
fluid	noun
fly	noun
fly	verb
flying	adjective
flying	noun
focus	noun
focus	verb
fold	noun
fold	verb
folding	adjective
folk	adjective
folk	noun
follow	verb
following	preposition
following	adjective
following	noun
fond	adjective
food	noun
fool	noun
foot	noun
footage	noun
football	noun
for	preposition
forbid	verb
force	noun
force	verb
forecast	noun
forecast	verb
foreign	adjective
foreigner	noun
forest	noun
forever	adverb
forge	verb
forget	verb
forgive	verb
fork	noun
form	noun
form	verb
formal	adjective
format	noun
formation	noun
former	adjective
formerly	adverb
formula	noun
formulate	verb
forth	adverb
forthcoming	adjective
fortunate	adjective
fortunately	adverb
fortune	noun
forty	number
forum	noun
forward	adjective
forward	adverb
fossil	noun
foster	verb
found	verb
foundation	noun
founder	noun
four	number
fourteen	number
fourth	ordinal number
fraction	noun
fragile	adjective
fragment	noun
frame	noun
frame	verb
framework	noun
franchise	noun
frankly	adverb
fraud	noun
free	adjective
free	adverb
free	verb
freedom	noun
freely	adverb
freeze	verb
frequency	noun
frequent	adjective
frequently	adverb
fresh	adjective
Friday	noun
fridge	noun
friend	noun
friendly	adjective
friendship	noun
frighten	verb
frightened	adjective
frightening	adjective
frog	noun
from	preposition
front	adjective
front	noun
frozen	adjective
fruit	noun
frustrated	adjective
frustrating	adjective
frustration	noun
fry	verb
fuel	noun
fuel	verb
fulfil	verb
full	adjective
full-time	adjective
full-time	adverb
fully	adverb
fun	adjective
fun	noun
function	noun
function	verb
functional	adjective
fund	noun
fund	verb
fundamental	adjective
fundamentally	adverb
funding	noun
fundraising	noun
funeral	noun
funny	adjective
fur	noun
furious	adjective
furniture	noun
further	adjective
further	adverb
furthermore	adverb
future	adjective
future	noun
gain	noun
gain	verb
gallery	noun
gallon	noun
gambling	noun
game	noun
gaming	noun
gang	noun
gap	noun
garage	noun
garden	noun
gas	noun
gate	noun
gather	verb
gathering	noun
gay	adjective
gaze	noun
gaze	verb
gear	noun
gender	noun
gene	noun
general	adjective
generally	adverb
generate	verb
generation	noun
generic	adjective
generous	adjective
genetic	adjective
genius	noun
genocide	noun
genre	noun
gentle	adjective
gentleman	noun
genuine	adjective
genuinely	adverb
geography	noun
gesture	noun
get	verb
ghost	noun
giant	adjective
giant	noun
gift	noun
gig	noun
girl	noun
girlfriend	noun
give	verb
glad	adjective
glance	noun
glance	verb
glass	noun
glimpse	noun
global	adjective
globalization	noun
globe	noun
glorious	adjective
glory	noun
glove	noun
go	noun
go	verb
goal	noun
god	noun
gold	noun
gold	adjective
golden	adjective
golf	noun
good	adjective
good	noun
goodbye	noun
goodbye	exclamation
goodness	noun
goods	noun
gorgeous	adjective
govern	verb
governance	noun
government	noun
governor	noun
grab	verb
grace	noun
grade	noun
grade	verb
gradually	adverb
graduate	noun
graduate	verb
grain	noun
grand	adjective
grandfather	noun
grandmother	noun
grandparent	noun
grant	noun
grant	verb
graphic	adjective
graphics	noun
grasp	verb
grass	noun
grateful	adjective
grave	adjective
grave	noun
gravity	noun
great	adjective
greatly	adverb
green	adjective
green	noun
greenhouse	noun
greet	verb
grey	adjective
grey	noun
grid	noun
grief	noun
grin	verb
grind	verb
grip	noun
grocery	noun
ground	noun
group	noun
grow	verb
growth	noun
guarantee	noun
guarantee	verb
guard	noun
guard	verb
guerrilla	noun
guess	noun
guess	verb
guest	noun
guidance	noun
guide	noun
guide	verb
guideline	noun
guilt	noun
guilty	adjective
guitar	noun
gun	noun
gut	noun
guy	noun
gym	noun
habit	noun
habitat	noun
hail	verb
hair	noun
half	noun
half	pronoun
half	adverb
half	determiner
halfway	adverb
hall	noun
halt	verb
hand	noun
hand	verb
handful	noun
handle	noun
handle	verb
handling	noun
handy	adjective
hang	verb
happen	verb
happily	adverb
happiness	noun
happy	adjective
harassment	noun
harbour	noun
hard	adjective
hard	adverb
hardly	adverb
hardware	noun
harm	noun
harm	verb
harmful	adjective
harmony	noun
harsh	adjective
harvest	noun
hat	noun
hate	noun
hate	verb
hatred	noun
haunt	verb
have	verb
have	auxiliary verb
have to	modal verb
hazard	noun
he	pronoun
head	noun
head	verb
headache	noun
headline	noun
headquarters	noun
heal	verb
health	noun
healthcare	noun
healthy	adjective
hear	verb
hearing	noun
heart	noun
heat	noun
heat	verb
heating	noun
heaven	noun
heavily	adverb
heavy	adjective
heel	noun
height	noun
heighten	verb
helicopter	noun
hell	noun
hello	noun
hello	exclamation
helmet	noun
help	noun
help	verb
helpful	adjective
hence	adverb
her	pronoun
her	determiner
herb	noun
here	adverb
heritage	noun
hero	noun
hers	pronoun
herself	pronoun
hesitate	verb
hey	exclamation
hi	exclamation
hidden	adjective
hide	verb
hierarchy	noun
high	adjective
high	noun
high	adverb
high-profile	adjective
highlight	noun
highlight	verb
highly	adverb
highway	noun
hilarious	adjective
hill	noun
him	pronoun
himself	pronoun
hint	noun
hint	verb
hip	noun
hire	noun
hire	verb
his	pronoun
his	determiner
historian	noun
historic	adjective
historical	adjective
history	noun
hit	noun
hit	verb
hobby	noun
hockey	noun
hold	noun
hold	verb
hole	noun
holiday	noun
hollow	adjective
holy	adjective
home	adjective
home	noun
home	adverb
homeland	noun
homeless	adjective
homework	noun
honest	adjective
honesty	noun
honour	noun
honour	verb
hook	noun
hook	verb
hope	noun
hope	verb
hopeful	adjective
hopefully	adverb
horizon	noun
horn	noun
horrible	adjective
horror	noun
horse	noun
hospital	noun
host	noun
host	verb
hostage	noun
hostile	adjective
hostility	noun
hot	adjective
hotel	noun
hour	noun
house	noun
house	verb
household	noun
housing	noun
how	adverb
however	adverb
huge	adjective
human	adjective
human	noun
humanitarian	adjective
humanity	noun
humble	adjective
humorous	adjective
humour	noun
hundred	number
hunger	noun
hungry	adjective
hunt	noun
hunt	verb
hunting	noun
hurricane	noun
hurry	noun
hurry	verb
hurt	noun
hurt	verb
hurt	adjective
husband	noun
hydrogen	noun
hypothesis	noun
I	pronoun
ice	noun
ice cream	noun
icon	noun
idea	noun
ideal	adjective
ideal	noun
identical	adjective
identification	noun
identify	verb
identity	noun
ideological	adjective
ideology	noun
idiot	noun
if	conjunction
ignorance	noun
ignore	verb
ill	adjective
illegal	adjective
illness	noun
illusion	noun
illustrate	verb
illustration	noun
image	noun
imagery	noun
imaginary	adjective
imagination	noun
imagine	verb
immediate	adjective
immediately	adverb
immense	adjective
immigrant	noun
immigration	noun
imminent	adjective
immune	adjective
impact	noun
impact	verb
impatient	adjective
implement	verb
implementation	noun
implication	noun
imply	verb
import	noun
import	verb
importance	noun
important	adjective
impose	verb
impossible	adjective
impress	verb
impressed	adjective
impression	noun
impressive	adjective
imprison	verb
imprisonment	noun
improve	verb
improvement	noun
in	preposition
in	adverb
inability	noun
inadequate	adjective
inappropriate	adjective
incentive	noun
inch	noun
incidence	noun
incident	noun
inclined	adjective
include	verb
included	adjective
including	preposition
inclusion	noun
income	noun
incorporate	verb
incorrect	adjective
increase	noun
increase	verb
increasingly	adverb
incredible	adjective
incredibly	adverb
incur	verb
indeed	adverb
independence	noun
independent	adjective
index	noun
indicate	verb
indication	noun
indicator	noun
indictment	noun
indigenous	adjective
indirect	adjective
individual	adjective
individual	noun
indoor	adjective
indoors	adverb
induce	verb
indulge	verb
industrial	adjective
industry	noun
inequality	noun
inevitable	adjective
infamous	adjective
infant	noun
infect	verb
infection	noun
infer	verb
inflation	noun
inflict	verb
influence	noun
influence	verb
influential	adjective
info	noun
inform	verb
informal	adjective
information	noun
infrastructure	noun
ingredient	noun
inhabitant	noun
inherent	adjective
inherit	verb
inhibit	verb
initial	adjective
initially	adverb
initiate	verb
initiative	noun
inject	verb
injection	noun
injure	verb
injured	adjective
injury	noun
injustice	noun
ink	noun
inmate	noun
inner	adjective
innocent	adjective
innovation	noun
innovative	adjective
input	noun
insect	noun
insert	verb
insertion	noun
inside	preposition
inside	adjective
inside	noun
inside	adverb
insider	noun
insight	noun
insist	verb
inspect	verb
inspection	noun
inspector	noun
inspiration	noun
inspire	verb
install	verb
installation	noun
instance	noun
instant	adjective
instantly	adverb
instead	adverb
instinct	noun
institute	noun
institution	noun
institutional	adjective
instruct	verb
instruction	noun
instructor	noun
instrument	noun
instrumental	adjective
insufficient	adjective
insult	noun
insurance	noun
intact	adjective
intake	noun
integral	adjective
integrate	verb
integrated	adjective
integration	noun
integrity	noun
intellectual	adjective
intellectual	noun
intelligence	noun
intelligent	adjective
intend	verb
intended	adjective
intense	adjective
intensify	verb
intensity	noun
intensive	adjective
intent	noun
intention	noun
interact	verb
interaction	noun
interactive	adjective
interest	noun
interest	verb
interested	adjective
interesting	adjective
interface	noun
interfere	verb
interference	noun
interim	adjective
interior	adjective
interior	noun
intermediate	adjective
internal	adjective
international	adjective
Internet	noun
interpret	verb
interpretation	noun
interrupt	verb
interval	noun
intervene	verb
intervention	noun
interview	noun
interview	verb
intimate	adjective
into	preposition
intriguing	adjective
introduce	verb
introduction	noun
invade	verb
invasion	noun
invent	verb
invention	noun
invest	verb
investigate	verb
investigation	noun
investigator	noun
investment	noun
investor	noun
invisible	adjective
invitation	noun
invite	verb
invoke	verb
involve	verb
involved	adjective
involvement	noun
iron	noun
iron	verb
ironic	adjective
ironically	adverb
irony	noun
irrelevant	adjective
island	noun
isolate	verb
isolated	adjective
isolation	noun
issue	noun
issue	verb
IT	noun
it	pronoun
item	noun
its	determiner
itself	pronoun
jacket	noun
jail	noun
jail	verb
jam	noun
January	noun
jazz	noun
jeans	noun
jet	noun
jewellery	noun
job	noun
join	verb
joint	adjective
joint	noun
joke	noun
joke	verb
journal	noun
journalism	noun
journalist	noun
journey	noun
joy	noun
judge	noun
judge	verb
judgement	noun
judicial	adjective
juice	noun
July	noun
jump	noun
jump	verb
junction	noun
June	noun
junior	adjective
jurisdiction	noun
jury	noun
just	adjective
just	adverb
justice	noun
justification	noun
justify	verb
keen	adjective
keep	verb
key	adjective
key	noun
key	verb
keyboard	noun
kick	noun
kick	verb
kid	noun
kidnap	verb
kidney	noun
kill	verb
killing	noun
kilometre	noun
kind	adjective
kind	noun
king	noun
kingdom	noun
kiss	noun
kiss	verb
kit	noun
kitchen	noun
knee	noun
knife	noun
knock	noun
knock	verb
know	verb
knowledge	noun
lab	noun
label	noun
label	verb
laboratory	noun
labour	noun
lack	noun
lack	verb
lad	noun
ladder	noun
lady	noun
lake	noun
lamp	noun
land	noun
land	verb
landing	noun
landlord	noun
landmark	noun
landscape	noun
lane	noun
language	noun
lap	noun
laptop	noun
large	adjective
large-scale	adjective
largely	adverb
laser	noun
last	noun
last	adverb
last	verb
last	determiner
late	adjective
late	adverb
lately	adverb
later	adverb
later	adjective
latest	adjective
latest	noun
latter	adjective
latter	noun
laugh	noun
laugh	verb
laughter	noun
launch	noun
launch	verb
law	noun
lawn	noun
lawsuit	noun
lawyer	noun
lay	verb
layer	noun
layout	noun
lazy	adjective
lead	noun
lead	verb
leader	noun
leadership	noun
leading	adjective
leaf	noun
leaflet	noun
league	noun
leak	noun
leak	verb
lean	verb
leap	noun
leap	verb
learn	verb
learning	noun
least	determiner
least	pronoun
least	adverb
leather	noun
leave	noun
leave	verb
lecture	noun
lecture	verb
left	adjective
left	noun
left	adverb
leg	noun
legacy	noun
legal	adjective
legend	noun
legendary	adjective
legislation	noun
legislative	adjective
legislature	noun
legitimate	adjective
leisure	noun
lemon	noun
lend	verb
length	noun
lengthy	adjective
lens	noun
lesbian	adjective
less	determiner
less	pronoun
less	adverb
lesser	adjective
lesson	noun
let	verb
lethal	adjective
letter	noun
level	adjective
level	noun
level	verb
liable	adjective
liberal	adjective
liberal	noun
liberation	noun
liberty	noun
library	noun
licence	noun
license	verb
lie	noun
lie	verb
life	noun
lifelong	adjective
lifestyle	noun
lifetime	noun
lift	noun
lift	verb
light	adjective
light	noun
light	verb
lighting	noun
like	preposition
like	noun
like	verb
likelihood	noun
likely	adjective
likewise	adverb
limb	noun
limit	noun
limit	verb
limitation	noun
limited	adjective
line	noun
line	verb
line-up	noun
linear	adjective
linger	verb
link	noun
link	verb
lion	noun
lip	noun
liquid	adjective
liquid	noun
list	noun
list	verb
listen	verb
listener	noun
listing	noun
literacy	noun
literally	adverb
literary	adjective
literature	noun
litre	noun
litter	noun
little	determiner
little	adjective
little	pronoun
little	adverb
live	adjective
live	adverb
live	verb
lively	adjective
liver	noun
living	adjective
living	noun
load	noun
load	verb
loan	noun
lobby	noun
lobby	verb
local	adjective
local	noun
locate	verb
located	adjective
location	noun
lock	noun
lock	verb
log	noun
log	verb
logic	noun
logical	adjective
logo	noun
lonely	adjective
long	adjective
long	adverb
long-standing	adjective
long-term	adjective
long-term	adverb
long-time	adjective
look	noun
look	verb
loom	verb
loop	noun
loose	adjective
lord	noun
lorry	noun
lose	verb
loss	noun
lost	adjective
lot	pronoun
lot	adverb
lot	determiner
lottery	noun
loud	adjective
loud	adverb
loudly	adverb
love	noun
love	verb
lovely	adjective
low	adjective
low	noun
low	adverb
lower	verb
loyal	adjective
loyalty	noun
luck	noun
lucky	adjective
lunch	noun
lung	noun
luxury	noun
lyric	noun
machine	noun
machinery	noun
mad	adjective
magazine	noun
magic	adjective
magic	noun
magical	adjective
magistrate	noun
magnetic	adjective
magnificent	adjective
magnitude	noun
mail	noun
mail	verb
main	adjective
mainland	noun
mainly	adverb
mainstream	adjective
mainstream	noun
maintain	verb
maintenance	noun
major	adjective
major	noun
majority	noun
make	noun
make	verb
make-up	noun
making	noun
male	adjective
male	noun
mall	noun
man	noun
manage	verb
management	noun
manager	noun
mandate	noun
mandatory	adjective
manifest	verb
manipulate	verb
manipulation	noun
manner	noun
manufacture	verb
manufacturing	noun
manuscript	noun
many	determiner
many	pronoun
map	noun
map	verb
marathon	noun
March	noun
march	noun
march	verb
margin	noun
marginal	adjective
marine	adjective
mark	noun
mark	verb
marker	noun
market	noun
market	verb
marketing	noun
marketplace	noun
marriage	noun
married	adjective
marry	verb
martial	adjective
mask	noun
mass	adjective
mass	noun
massacre	noun
massive	adjective
master	noun
master	verb
match	noun
match	verb
matching	adjective
mate	noun
mate	verb
material	adjective
material	noun
mathematical	adjective
mathematics	noun
maths	noun
matter	noun
matter	verb
mature	adjective
maximize	verb
maximum	adjective
maximum	noun
May	noun
may	modal verb
maybe	adverb
mayor	noun
me	pronoun
meal	noun
mean	verb
meaning	noun
meaningful	adjective
means	noun
meantime	noun
meanwhile	adverb
measure	noun
measure	verb
measurement	noun
meat	noun
mechanic	noun
mechanical	adjective
mechanism	noun
medal	noun
media	noun
medical	adjective
medication	noun
medicine	noun
medieval	adjective
meditation	noun
medium	adjective
medium	noun
meet	verb
meeting	noun
melody	noun
melt	verb
member	noun
membership	noun
memo	noun
memoir	noun
memorable	adjective
memorial	noun
memory	noun
mental	adjective
mention	noun
mention	verb
mentor	noun
menu	noun
merchant	noun
mercy	noun
mere	adjective
merely	adverb
merge	verb
merger	noun
merit	noun
mess	noun
message	noun
metal	noun
metaphor	noun
method	noun
methodology	noun
metre	noun
middle	adjective
middle	noun
midnight	noun
midst	noun
might	modal verb
migration	noun
mild	adjective
mile	noun
militant	adjective
militant	noun
military	adjective
military	noun
militia	noun
milk	noun
mill	noun
million	number
mind	noun
mind	verb
mine	noun
mine	pronoun
miner	noun
mineral	noun
minimal	adjective
minimize	verb
minimum	adjective
minimum	noun
mining	noun
minister	noun
ministry	noun
minor	adjective
minority	noun
minute	adjective
minute	noun
miracle	noun
mirror	noun
miserable	adjective
misery	noun
misleading	adjective
miss	verb
missile	noun
missing	adjective
mission	noun
mistake	noun
mistake	verb
mix	noun
mix	verb
mixed	adjective
mixture	noun
mob	noun
mobile	adjective
mobile	noun
mobility	noun
mobilize	verb
mode	noun
model	noun
model	verb
moderate	adjective
modern	adjective
modest	adjective
modification	noun
modify	verb
moment	noun
momentum	noun
Monday	noun
money	noun
monitor	noun
monitor	verb
monk	noun
monkey	noun
monopoly	noun
monster	noun
month	noun
monthly	adjective
monument	noun
mood	noun
moon	noun
moral	adjective
moral	noun
morality	noun
more	determiner
more	pronoun
more	adverb
moreover	adverb
morning	noun
mortgage	noun
mosque	noun
most	determiner
most	pronoun
most	adverb
mostly	adverb
mother	noun
motion	noun
motivate	verb
motivation	noun
motive	noun
motor	adjective
motor	noun
motorcycle	noun
motorist	noun
mount	verb
mountain	noun
mouse	noun
mouth	noun
move	noun
move	verb
movement	noun
movie	noun
moving	adjective
much	determiner
much	pronoun
much	adverb
mud	noun
multiple	adjective
multiply	verb
mum	noun
municipal	adjective
murder	noun
murder	verb
muscle	noun
museum	noun
music	noun
musical	adjective
musical	noun
musician	noun
must	modal verb
mutual	adjective
my	determiner
myself	pronoun
mysterious	adjective
mystery	noun
myth	noun
nail	noun
naked	adjective
name	noun
name	verb
namely	adverb
narrative	adjective
narrative	noun
narrow	adjective
narrow	verb
nasty	adjective
nation	noun
national	adjective
national	noun
nationwide	adjective
native	adjective
native	noun
natural	adjective
naturally	adverb
nature	noun
naval	adjective
navigation	noun
near	preposition
near	adjective
near	adverb
nearby	adjective
nearby	adverb
nearly	adverb
neat	adjective
necessarily	adverb
necessary	adjective
necessity	noun
neck	noun
need	modal verb
need	noun
need	verb
needle	noun
negative	adjective
negative	noun
neglect	verb
negotiate	verb
negotiation	noun
neighbour	noun
neighbourhood	noun
neighbouring	adjective
neither	determiner
neither	pronoun
neither	adverb
nerve	noun
nervous	adjective
nest	noun
net	adjective
net	noun
network	noun
neutral	adjective
never	adverb
nevertheless	adverb
new	adjective
newly	adverb
news	noun
newsletter	noun
newspaper	noun
next	adjective
next	noun
next	adverb
next to	preposition
nice	adjective
niche	noun
night	noun
nightmare	noun
nine	number
nineteen	number
ninety	number
no	determiner
no	exclamation
no one	pronoun
noble	adjective
nobody	pronoun
nod	verb
noise	noun
noisy	adjective
nominate	verb
nomination	noun
nominee	noun
non-profit	adjective
none	pronoun
nonetheless	adverb
nonsense	noun
noon	noun
nor	conjunction
nor	adverb
norm	noun
normal	adjective
normal	noun
normally	adverb
north	adjective
north	noun
north	adverb
northern	adjective
nose	noun
not	adverb
notable	adjective
notably	adverb
note	noun
note	verb
notebook	noun
nothing	pronoun
notice	noun
notice	verb
notify	verb
notion	noun
notorious	adjective
novel	adjective
novel	noun
novelist	noun
November	noun
now	conjunction
now	adverb
nowadays	adverb
nowhere	adverb
nuclear	adjective
number	noun
number	verb
numerous	adjective
nurse	noun
nursery	noun
nursing	noun
nut	noun
nutrition	noun
o'clock	adverb
obesity	noun
obey	verb
object	noun
object	verb
objection	noun
objective	adjective
objective	noun
obligation	noun
oblige	verb
observation	noun
observe	verb
observer	noun
obsess	verb
obsession	noun
obstacle	noun
obtain	verb
obvious	adjective
obviously	adverb
occasion	noun
occasional	adjective
occasionally	adverb
occupation	noun
occupy	verb
occur	verb
occurrence	noun
ocean	noun
October	noun
odd	adjective
odds	noun
of	preposition
off	preposition
off	adverb
offence	noun
offend	verb
offender	noun
offensive	adjective
offer	noun
offer	verb
offering	noun
office	noun
officer	noun
official	adjective
official	noun
offspring	noun
often	adverb
oh	exclamation
oil	noun
OK	adjective
OK	adverb
OK	exclamation
old	adjective
old-fashioned	adjective
on	preposition
on	adverb
once	conjunction
once	adverb
one	number
one	determiner
one	pronoun
ongoing	adjective
onion	noun
online	adjective
online	adverb
only	adjective
only	adverb
onto	preposition
open	adjective
open	verb
opening	noun
openly	adverb
opera	noun
operate	verb
operation	noun
operational	adjective
operator	noun
opinion	noun
opponent	noun
opportunity	noun
oppose	verb
opposed	adjective
opposite	preposition
opposite	adjective
opposite	noun
opposite	adverb
opposition	noun
opt	verb
optical	adjective
optimism	noun
optimistic	adjective
option	noun
or	conjunction
oral	adjective
orange	adjective
orange	noun
orchestra	noun
order	noun
order	verb
ordinary	adjective
organ	noun
organic	adjective
organization	noun
organizational	adjective
organize	verb
organized	adjective
organizer	noun
orientation	noun
origin	noun
original	adjective
original	noun
originally	adverb
originate	verb
other	adjective
other	pronoun
otherwise	adverb
ought	modal verb
our	determiner
ours	pronoun
ourselves	pronoun
out	preposition
out	adverb
outbreak	noun
outcome	noun
outdoor	adjective
outdoors	adverb
outer	adjective
outfit	noun
outing	noun
outlet	noun
outline	noun
outline	verb
outlook	noun
output	noun
outrage	noun
outside	preposition
outside	adjective
outside	noun
outside	adverb
outsider	noun
outstanding	adjective
oven	noun
over	preposition
over	adverb
overall	adjective
overall	adverb
overcome	verb
overlook	verb
overly	adverb
overnight	adverb
overseas	adjective
overseas	adverb
oversee	verb
overturn	verb
overwhelm	verb
overwhelming	adjective
owe	verb
own	adjective
own	pronoun
own	verb
owner	noun
ownership	noun
oxygen	noun
pace	noun
pace	verb
pack	noun
pack	verb
package	noun
package	verb
packet	noun
pad	noun
page	noun
pain	noun
painful	adjective
paint	noun
paint	verb
painter	noun
painting	noun
pair	noun
palace	noun
pale	adjective
palm	noun
pan	noun
panel	noun
panic	noun
pants	noun
paper	noun
parade	noun
paragraph	noun
parallel	adjective
parallel	noun
parameter	noun
parent	noun
parental	adjective
parish	noun
park	noun
park	verb
parking	noun
parliament	noun
parliamentary	adjective
part	noun
part-time	adjective
partial	adjective
partially	adverb
participant	noun
participate	verb
participation	noun
particular	adjective
particularly	adverb
partly	adverb
partner	noun
partnership	noun
party	noun
pass	noun
pass	verb
passage	noun
passenger	noun
passing	noun
passion	noun
passionate	adjective
passive	adjective
passport	noun
password	noun
past	preposition
past	adjective
past	noun
past	adverb
pastor	noun
patch	noun
patent	noun
path	noun
pathway	noun
patience	noun
patient	adjective
patient	noun
patrol	noun
patron	noun
pattern	noun
pause	verb
pay	noun
pay	verb
payment	noun
peace	noun
peaceful	adjective
peak	noun
peasant	noun
peculiar	adjective
peer	noun
pen	noun
penalty	noun
pencil	noun
penny	noun
pension	noun
people	noun
pepper	noun
per	preposition
per cent	noun
per cent	adverb
per cent	adjective
perceive	verb
percentage	noun
perception	noun
perfect	adjective
perfectly	adverb
perform	verb
performance	noun
perhaps	adverb
period	noun
permanent	adjective
permanently	adverb
permission	noun
permit	noun
permit	verb
persist	verb
persistent	adjective
person	noun
personal	adjective
personality	noun
personally	adverb
personnel	noun
perspective	noun
persuade	verb
pet	noun
petition	noun
petrol	noun
phase	noun
phenomenon	noun
philosopher	noun
philosophical	adjective
philosophy	noun
phone	noun
phone	verb
photo	noun
photograph	noun
photograph	verb
photographer	noun
photography	noun
phrase	noun
physical	adjective
physician	noun
physics	noun
piano	noun
pick	noun
pick	verb
picture	noun
picture	verb
piece	noun
pig	noun
pile	noun
pile	verb
pill	noun
pilot	noun
pin	noun
pin	verb
pink	adjective
pink	noun
pioneer	noun
pioneer	verb
pipe	noun
pipeline	noun
pirate	noun
pit	noun
pitch	noun
pity	noun
place	noun
place	verb
placement	noun
plain	adjective
plan	noun
plan	verb
plane	noun
planet	noun
planning	noun
plant	noun
plant	verb
plastic	adjective
plastic	noun
plate	noun
platform	noun
play	noun
play	verb
player	noun
plea	noun
plead	verb
pleasant	adjective
please	verb
please	exclamation
pleased	adjective
pleasure	noun
pledge	noun
pledge	verb
plenty	pronoun
plot	noun
plot	verb
plug	noun
plug	verb
plunge	verb
plus	conjunction
plus	preposition
plus	adjective
plus	noun
pocket	noun
poem	noun
poet	noun
poetry	noun
point	noun
point	verb
pointed	adjective
poison	noun
poison	verb
poisonous	adjective
pole	noun
police	noun
policeman	noun
policy	noun
polite	adjective
political	adjective
politician	noun
politics	noun
poll	noun
pollution	noun
pond	noun
pool	noun
poor	adjective
pop	adjective
pop	noun
pop	verb
popular	adjective
popularity	noun
population	noun
port	noun
portfolio	noun
portion	noun
portrait	noun
portray	verb
pose	verb
position	noun
position	verb
positive	adjective
positive	noun
possess	verb
possession	noun
possibility	noun
possible	adjective
possibly	adverb
post	noun
post	verb
post-war	adjective
poster	noun
postpone	verb
pot	noun
potato	noun
potential	adjective
potential	noun
potentially	adverb
pound	noun
pour	verb
poverty	noun
powder	noun
power	noun
power	verb
powerful	adjective
practical	adjective
practice	noun
practise	verb
practitioner	noun
praise	noun
praise	verb
pray	verb
prayer	noun
preach	verb
precede	verb
precedent	noun
precious	adjective
precise	adjective
precisely	adverb
precision	noun
predator	noun
predecessor	noun
predict	verb
predictable	adjective
prediction	noun
predominantly	adverb
prefer	verb
preference	noun
pregnancy	noun
pregnant	adjective
prejudice	noun
preliminary	adjective
premier	adjective
premise	noun
premium	noun
preparation	noun
prepare	verb
prepared	adjective
prescribe	verb
prescription	noun
presence	noun
present	adjective
present	noun
present	verb
presentation	noun
presently	adverb
preservation	noun
preserve	verb
preside	verb
presidency	noun
president	noun
presidential	adjective
press	noun
press	verb
pressure	noun
prestigious	adjective
presumably	adverb
presume	verb
pretend	verb
pretty	adjective
pretty	adverb
prevail	verb
prevalence	noun
prevent	verb
prevention	noun
previous	adjective
previously	adverb
prey	noun
price	noun
price	verb
pride	noun
priest	noun
primarily	adverb
primary	adjective
prime	adjective
prince	noun
princess	noun
principal	adjective
principal	noun
principle	noun
print	noun
print	verb
printer	noun
printing	noun
prior	adjective
priority	noun
prison	noun
prisoner	noun
privacy	noun
private	adjective
privatization	noun
privilege	noun
prize	noun
probability	noun
probable	adjective
probably	adverb
probe	noun
problem	noun
problematic	adjective
procedure	noun
proceed	verb
proceeding	noun
proceeds	noun
process	noun
process	verb
processing	noun
processor	noun
proclaim	verb
produce	noun
produce	verb
producer	noun
product	noun
production	noun
productive	adjective
productivity	noun
profession	noun
professional	adjective
professional	noun
professor	noun
profile	noun
profit	noun
profitable	adjective
profound	adjective
program	noun
program	verb
programme	noun
programming	noun
progress	noun
progress	verb
progressive	adjective
prohibit	verb
project	noun
project	verb
projection	noun
prominent	adjective
promise	noun
promise	verb
promising	adjective
promote	verb
promotion	noun
prompt	verb
pronounce	verb
pronounced	adjective
proof	noun
propaganda	noun
proper	adjective
properly	adverb
property	noun
proportion	noun
proposal	noun
propose	verb
proposition	noun
prosecute	verb
prosecution	noun
prosecutor	noun
prospect	noun
prospective	adjective
prosperity	noun
protect	verb
protection	noun
protective	adjective
protein	noun
protest	noun
protest	verb
protester	noun
protocol	noun
proud	adjective
prove	verb
provide	verb
province	noun
provincial	adjective
provision	noun
provoke	verb
psychiatric	adjective
psychological	adjective
psychologist	noun
psychology	noun
pub	noun
public	adjective
public	noun
publication	noun
publicity	noun
publish	verb
publishing	noun
pull	noun
pull	verb
pulse	noun
pump	noun
pump	verb
punch	noun
punch	verb
punish	verb
punishment	noun
punk	noun
pupil	noun
purchase	noun
purchase	verb
pure	adjective
purely	adverb
purple	adjective
purple	noun
purpose	noun
pursue	verb
pursuit	noun
push	noun
push	verb
put	verb
puzzle	noun
qualification	noun
qualified	adjective
qualify	verb
quality	noun
quantity	noun
quarter	noun
queen	noun
query	noun
quest	noun
question	noun
question	verb
questionnaire	noun
queue	noun
queue	verb
quick	adjective
quickly	adverb
quiet	adjective
quietly	adverb
quit	verb
quite	adverb
quota	noun
quotation	noun
quote	noun
quote	verb
race	noun
race	verb
racial	adjective
racing	noun
racism	noun
racist	adjective
racist	noun
radar	noun
radiation	noun
radical	adjective
radio	noun
rage	noun
raid	noun
rail	noun
railway	noun
rain	noun
rain	verb
raise	verb
rally	noun
rally	verb
random	adjective
range	noun
range	verb
rank	noun
rank	verb
ranking	noun
rape	noun
rape	verb
rapid	adjective
rapidly	adverb
rare	adjective
rarely	adverb
rat	noun
rate	noun
rate	verb
rather	adverb
rating	noun
ratio	noun
rational	adjective
raw	adjective
ray	noun
reach	noun
reach	verb
react	verb
reaction	noun
read	verb
reader	noun
readily	adverb
reading	noun
ready	adjective
real	adjective
realistic	adjective
reality	noun
realization	noun
realize	verb
really	adverb
realm	noun
rear	adjective
reason	noun
reasonable	adjective
reasonably	adverb
reasoning	noun
reassure	verb
rebel	noun
rebellion	noun
rebuild	verb
recall	verb
receipt	noun
receive	verb
receiver	noun
recent	adjective
recently	adverb
reception	noun
recession	noun
recipe	noun
recipient	noun
reckon	verb
recognition	noun
recognize	verb
recommend	verb
recommendation	noun
reconstruction	noun
record	noun
record	verb
recording	noun
recount	verb
recover	verb
recovery	noun
recruit	verb
recruitment	noun
recycle	verb
red	adjective
red	noun
reduce	verb
reduction	noun
refer	verb
referee	noun
reference	noun
referendum	noun
reflect	verb
reflection	noun
reform	noun
reform	verb
refuge	noun
refugee	noun
refusal	noun
refuse	verb
regain	verb
regard	noun
regard	verb
regardless	adverb
regime	noun
region	noun
regional	adjective
register	noun
register	verb
registration	noun
regret	noun
regret	verb
regular	adjective
regularly	adverb
regulate	verb
regulation	noun
regulator	noun
regulatory	adjective
rehabilitation	noun
reign	noun
reinforce	verb
reject	verb
rejection	noun
relate	verb
related	adjective
relation	noun
relationship	noun
relative	adjective
relative	noun
relatively	adverb
relax	verb
relaxed	adjective
relaxing	adjective
release	noun
release	verb
relevance	noun
relevant	adjective
reliability	noun
reliable	adjective
relief	noun
relieve	verb
relieved	adjective
religion	noun
religious	adjective
reluctant	adjective
rely	verb
remain	verb
remainder	noun
remains	noun
remark	noun
remark	verb
remarkable	adjective
remarkably	adverb
remedy	noun
remember	verb
remind	verb
reminder	noun
remote	adjective
removal	noun
remove	verb
render	verb
renew	verb
renowned	adjective
rent	noun
rent	verb
rental	noun
repair	noun
repair	verb
repeat	noun
repeat	verb
repeated	adjective
replace	verb
replacement	noun
reply	noun
reply	verb
report	noun
report	verb
reportedly	adverb
reporter	noun
reporting	noun
represent	verb
representation	noun
representative	adjective
representative	noun
reproduce	verb
reproduction	noun
republic	noun
reputation	noun
request	noun
request	verb
require	verb
requirement	noun
rescue	noun
rescue	verb
research	noun
research	verb
researcher	noun
resemble	verb
reservation	noun
reserve	noun
reserve	verb
reside	verb
residence	noun
resident	adjective
resident	noun
residential	adjective
residue	noun
resign	verb
resignation	noun
resist	verb
resistance	noun
resolution	noun
resolve	verb
resort	noun
resource	noun
respect	noun
respect	verb
respective	adjective
respectively	adverb
respond	verb
response	noun
responsibility	noun
responsible	adjective
rest	noun
rest	verb
restaurant	noun
restoration	noun
restore	verb
restraint	noun
restrict	verb
restriction	noun
result	noun
result	verb
resume	verb
retail	noun
retain	verb
retire	verb
retired	adjective
retirement	noun
retreat	noun
retreat	verb
retrieve	verb
return	noun
return	verb
reveal	verb
revelation	noun
revenge	noun
revenue	noun
reverse	verb
review	noun
review	verb
revise	verb
revision	noun
revival	noun
revive	verb
revolution	noun
revolutionary	adjective
reward	noun
reward	verb
rhetoric	noun
rhythm	noun
rice	noun
rich	adjective
rid	verb
ride	noun
ride	verb
ridiculous	adjective
rifle	noun
right	adjective
right	noun
right	adverb
ring	noun
ring	verb
riot	noun
rip	verb
rise	noun
rise	verb
risk	noun
risk	verb
risky	adjective
ritual	noun
rival	noun
rival	adjective
river	noun
road	noun
rob	verb
robbery	noun
robot	noun
robust	adjective
rock	noun
rock	verb
rocket	noun
rod	noun
role	noun
roll	noun
roll	verb
romance	noun
romantic	adjective
roof	noun
room	noun
root	noun
rope	noun
rose	noun
rotate	verb
rotation	noun
rough	adjective
roughly	adverb
round	preposition
round	adjective
round	noun
round	adverb
route	noun
routine	adjective
routine	noun
row	noun
royal	adjective
rub	verb
rubber	noun
rubber	adjective
rubbish	noun
rude	adjective
rugby	noun
ruin	noun
ruin	verb
rule	noun
rule	verb
ruling	noun
rumour	noun
run	noun
run	verb
runner	noun
running	noun
rural	adjective
rush	noun
rush	verb
sack	verb
sacred	adjective
sacrifice	noun
sacrifice	verb
sad	adjective
sadly	adverb
safe	adjective
safety	noun
sail	noun
sail	verb
sailing	noun
sailor	noun
saint	noun
sake	noun
salad	noun
salary	noun
sale	noun
salt	noun
same	adjective
same	pronoun
same	adverb
sample	noun
sample	verb
sanction	noun
sand	noun
sandwich	noun
satellite	noun
satisfaction	noun
satisfied	adjective
satisfy	verb
Saturday	noun
sauce	noun
save	verb
saving	noun
say	noun
say	verb
scale	noun
scan	verb
scandal	noun
scare	verb
scared	adjective
scary	adjective
scattered	adjective
scenario	noun
scene	noun
sceptical	adjective
schedule	noun
schedule	verb
scheme	noun
scholar	noun
scholarship	noun
school	noun
science	noun
scientific	adjective
scientist	noun
scope	noun
score	noun
score	verb
scratch	verb
scream	noun
scream	verb
screen	noun
screen	verb
screening	noun
screw	verb
script	noun
scrutiny	noun
sculpture	noun
sea	noun
seal	noun
seal	verb
search	noun
search	verb
season	noun
seat	noun
seat	verb
second	noun
second	adverb
second	determiner
second	number
secondary	adjective
secondly	adverb
secret	adjective
secret	noun
secretary	noun
section	noun
sector	noun
secular	adjective
secure	adjective
secure	verb
security	noun
see	verb
seed	noun
seek	verb
seeker	noun
seem	linking verb
seemingly	adverb
segment	noun
seize	verb
seldom	adverb
select	verb
selection	noun
selective	adjective
self	noun
sell	verb
seminar	noun
senator	noun
send	verb
senior	adjective
sensation	noun
sense	noun
sense	verb
sensible	adjective
sensitive	adjective
sensitivity	noun
sentence	noun
sentence	verb
sentiment	noun
separate	adjective
separate	verb
separation	noun
September	noun
sequence	noun
serial	adjective
series	noun
serious	adjective
seriously	adverb
servant	noun
serve	verb
service	noun
session	noun
set	noun
set	verb
set-up	noun
setting	noun
settle	verb
settlement	noun
settler	noun
seven	number
seventeen	number
seventy	number
several	determiner
several	pronoun
severe	adjective
severely	adverb
sex	noun
sexual	adjective
sexuality	noun
sexy	adjective
shade	noun
shadow	noun
shake	noun
shake	verb
shall	modal verb
shallow	adjective
shame	noun
shape	noun
shape	verb
shaped	adjective
share	noun
share	verb
shareholder	noun
sharp	adjective
shatter	verb
she	pronoun
shed	verb
sheep	noun
sheer	adjective
sheet	noun
shelf	noun
shell	noun
shelter	noun
shelter	verb
shift	noun
shift	verb
shine	verb
shiny	adjective
ship	noun
ship	verb
shipping	noun
shirt	noun
shock	noun
shock	verb
shocked	adjective
shocking	adjective
shoe	noun
shoot	noun
shoot	verb
shooting	noun
shop	noun
shop	verb
shopping	noun
shore	noun
short	adjective
short-term	adjective
shortage	noun
shortly	adverb
shot	noun
should	modal verb
shoulder	noun
shout	noun
shout	verb
show	noun
show	verb
shower	noun
shrink	verb
shrug	verb
shut	verb
shut	adjective
shy	adjective
sibling	noun
sick	adjective
side	noun
sigh	noun
sigh	verb
sight	noun
sign	noun
sign	verb
signal	noun
signal	verb
signature	noun
significance	noun
significant	adjective
significantly	adverb
silence	noun
silent	adjective
silk	noun
silly	adjective
silver	noun
silver	adjective
similar	adjective
similarity	noun
similarly	adverb
simple	adjective
simply	adverb
simulate	verb
simulation	noun
simultaneously	adverb
sin	noun
since	conjunction
since	preposition
since	adverb
sincere	adjective
sing	verb
singer	noun
singing	noun
single	adjective
single	noun
sink	verb
sir	noun
sister	noun
sit	verb
site	noun
situated	adjective
situation	noun
six	number
sixteen	number
sixty	number
size	noun
sketch	noun
ski	noun
ski	verb
ski	adjective
skiing	noun
skill	noun
skilled	adjective
skin	noun
skip	verb
skirt	noun
skull	noun
sky	noun
slam	verb
slap	verb
slash	verb
slave	noun
slavery	noun
sleep	noun
sleep	verb
slice	noun
slice	verb
slide	noun
slide	verb
slight	adjective
slightly	adverb
slip	verb
slogan	noun
slope	noun
slope	verb
slot	noun
slow	adjective
slow	verb
slowly	adverb
small	adjective
smart	adjective
smash	verb
smell	noun
smell	verb
smile	noun
smile	verb
smoke	noun
smoke	verb
smoking	noun
smooth	adjective
snake	noun
snap	verb
snow	noun
snow	verb
so	conjunction
so	adverb
so-called	adjective
soak	verb
soap	noun
soar	verb
soccer	noun
social	adjective
socialist	adjective
society	noun
sock	noun
soft	adjective
software	noun
soil	noun
solar	adjective
soldier	noun
sole	adjective
solely	adverb
solicitor	noun
solid	adjective
solid	noun
solidarity	noun
solo	adjective
solo	noun
solution	noun
solve	verb
some	determiner
some	pronoun
somebody	pronoun
somehow	adverb
someone	pronoun
something	pronoun
sometime	adverb
sometimes	adverb
somewhat	adverb
somewhere	pronoun
somewhere	adverb
son	noun
song	noun
soon	adverb
sophisticated	adjective
sorry	adjective
sorry	exclamation
sort	noun
sort	verb
soul	noun
sound	adjective
sound	noun
sound	verb
soup	noun
source	noun
south	adjective
south	noun
south	adverb
southern	adjective
sovereignty	noun
space	noun
spam	noun
span	verb
spare	adjective
spare	verb
spark	verb
speak	verb
speaker	noun
special	adjective
specialist	adjective
specialist	noun
specialize	verb
specialized	adjective
species	noun
specific	adjective
specifically	adverb
specification	noun
specify	verb
specimen	noun
spectacle	noun
spectacular	adjective
spectator	noun
spectrum	noun
speculate	verb
speculation	noun
speech	noun
speed	noun
speed	verb
spell	noun
spell	verb
spelling	noun
spend	verb
spending	noun
sphere	noun
spicy	adjective
spider	noun
spill	verb
spin	noun
spin	verb
spine	noun
spirit	noun
spiritual	adjective
spite	noun
split	noun
split	verb
spoil	verb
spoken	adjective
spokesman	noun
spokesperson	noun
spokeswoman	noun
sponsor	noun
sponsor	verb
sponsorship	noun
spoon	noun
sport	noun
sporting	adjective
spot	noun
spot	verb
spotlight	noun
spouse	noun
spread	noun
spread	verb
spring	noun
spring	verb
spy	noun
squad	noun
square	adjective
square	noun
squeeze	verb
stab	verb
stability	noun
stabilize	verb
stable	adjective
stadium	noun
staff	noun
stage	noun
stage	verb
stair	noun
stake	noun
stall	noun
stamp	noun
stance	noun
stand	noun
stand	verb
standard	adjective
standard	noun
standing	adjective
star	noun
star	verb
stare	verb
stark	adjective
start	noun
start	verb
starve	verb
state	noun
state	verb
state	adjective
statement	noun
station	noun
statistic	noun
statistical	adjective
statue	noun
status	noun
stay	noun
stay	verb
steadily	adverb
steady	adjective
steal	verb
steam	noun
steel	noun
steep	adjective
steer	verb
stem	noun
stem	verb
step	noun
step	verb
stereotype	noun
stick	noun
stick	verb
sticky	adjective
stiff	adjective
still	adjective
still	adverb
stimulate	verb
stimulus	noun
stir	verb
stock	noun
stomach	noun
stone	noun
stop	noun
stop	verb
storage	noun
store	noun
store	verb
storm	noun
story	noun
straight	adjective
straight	adverb
straightforward	adjective
strain	noun
strand	noun
strange	adjective
stranger	noun
strategic	adjective
strategy	noun
stream	noun
street	noun
strength	noun
strengthen	verb
stress	noun
stress	verb
stretch	noun
stretch	verb
strict	adjective
strictly	adverb
strike	noun
strike	verb
striking	adjective
string	noun
strip	noun
strip	verb
strive	verb
stroke	noun
strong	adjective
strongly	adverb
structural	adjective
structure	noun
structure	verb
struggle	noun
struggle	verb
student	noun
studio	noun
study	noun
study	verb
stuff	noun
stuff	verb
stumble	verb
stun	verb
stunning	adjective
stupid	adjective
style	noun
subject	adjective
subject	noun
sublist	noun
submission	noun
submit	verb
subscriber	noun
subscription	noun
subsequent	adjective
subsequently	adverb
subsidy	noun
substance	noun
substantial	adjective
substantially	adverb
substitute	noun
substitute	verb
substitution	noun
subtle	adjective
suburb	noun
suburban	adjective
succeed	verb
success	noun
successful	adjective
successfully	adverb
succession	noun
successive	adjective
successor	noun
such	determiner
such	pronoun
suck	verb
sudden	adjective
suddenly	adverb
sue	verb
suffer	verb
suffering	noun
sufficient	adjective
sufficiently	adverb
sugar	noun
suggest	verb
suggestion	noun
suicide	noun
suit	noun
suit	verb
suitable	adjective
suite	noun
sum	noun
sum	verb
summarize	verb
summary	noun
summer	noun
summit	noun
sun	noun
Sunday	noun
super	adjective
superb	adjective
superior	adjective
supermarket	noun
supervise	verb
supervision	noun
supervisor	noun
supplement	noun
supplement	verb
supply	noun
supply	verb
support	noun
support	verb
supporter	noun
supportive	adjective
suppose	verb
supposedly	adverb
suppress	verb
supreme	adjective
sure	adjective
sure	adverb
surely	adverb
surface	noun
surge	noun
surgeon	noun
surgery	noun
surgical	adjective
surplus	noun
surprise	noun
surprise	verb
surprised	adjective
surprising	adjective
surrender	verb
surround	verb
surrounding	adjective
surveillance	noun
survey	noun
survey	verb
survival	noun
survive	verb
survivor	noun
suspect	noun
suspect	verb
suspend	verb
suspension	noun
suspicion	noun
suspicious	adjective
sustain	verb
sustainable	adjective
swallow	verb
swear	verb
sweater	noun
sweep	verb
sweet	adjective
sweet	noun
swim	noun
swim	verb
swimming	noun
swing	noun
swing	verb
switch	noun
switch	verb
sword	noun
symbol	noun
symbolic	adjective
sympathetic	adjective
sympathy	noun
symptom	noun
syndrome	noun
synthesis	noun
system	noun
systematic	adjective
T-shirt	noun
table	noun
tablet	noun
tackle	noun
tackle	verb
tactic	noun
tactical	adjective
tag	noun
tail	noun
take	verb
tale	noun
talent	noun
talented	adjective
talk	noun
talk	verb
tall	adjective
tank	noun
tap	noun
tap	verb
tape	noun
target	noun
target	verb
task	noun
taste	noun
taste	verb
tax	noun
tax	verb
taxi	noun
taxpayer	noun
tea	noun
teach	verb
teacher	noun
teaching	noun
team	noun
tear	noun
tear	verb
technical	adjective
technique	noun
technological	adjective
technology	noun
teenage	adjective
teenager	noun
teens	noun
telephone	noun
telephone	verb
television	noun
tell	verb
temperature	noun
temple	noun
temporarily	adverb
temporary	adjective
tempt	verb
ten	number
tenant	noun
tend	verb
tendency	noun
tender	adjective
tennis	noun
tension	noun
tent	noun
tenure	noun
term	noun
term	verb
terminal	adjective
terminal	noun
terminate	verb
terms	noun
terrain	noun
terrible	adjective
terribly	adverb
terrific	adjective
terrify	verb
territory	noun
terror	noun
terrorism	noun
terrorist	noun
test	noun
test	verb
testify	verb
testimony	noun
testing	noun
text	noun
textbook	noun
texture	noun
than	conjunction
thank	verb
thankfully	adverb
thanks	noun
thanks	exclamation
that	conjunction
that	determiner
that	pronoun
that	adverb
the	definite article
theatre	noun
theatrical	adjective
theft	noun
their	determiner
theirs	pronoun
them	pronoun
theme	noun
themselves	pronoun
then	adverb
theology	noun
theoretical	adjective
theory	noun
therapist	noun
therapy	noun
there	adverb
thereafter	adverb
thereby	adverb
therefore	adverb
thesis	noun
they	pronoun
thick	adjective
thief	noun
thin	adjective
thing	noun
think	verb
thinking	noun
third	noun
third	ordinal number
thirsty	adjective
thirteen	number
thirty	number
this	determiner
this	pronoun
this	adverb
thorough	adjective
thoroughly	adverb
though	conjunction
though	adverb
thought	noun
thought-provoking	adjective
thoughtful	adjective
thousand	number
thread	noun
threat	noun
threaten	verb
three	number
threshold	noun
thrilled	adjective
thrive	verb
throat	noun
through	preposition
through	adverb
throughout	preposition
throughout	adverb
throw	verb
thumb	noun
Thursday	noun
thus	adverb
ticket	noun
tide	noun
tidy	adjective
tidy	verb
tie	noun
tie	verb
tight	adjective
tighten	verb
till	conjunction
till	preposition
timber	noun
time	noun
time	verb
timely	adjective
timing	noun
tin	noun
tiny	adjective
tip	noun
tip	verb
tired	adjective
tissue	noun
title	noun
title	verb
to	preposition
to	infinitive marker
tobacco	noun
today	noun
today	adverb
toe	noun
together	adverb
toilet	noun
tolerance	noun
tolerate	verb
toll	noun
tomato	noun
tomorrow	noun
tomorrow	adverb
ton	noun
tone	noun
tongue	noun
tonight	noun
tonight	adverb
tonne	noun
too	adverb
tool	noun
tooth	noun
top	adjective
top	noun
top	verb
topic	noun
torture	noun
torture	verb
toss	verb
total	adjective
total	noun
total	verb
totally	adverb
touch	noun
touch	verb
tough	adjective
tour	noun
tour	verb
tourism	noun
tourist	noun
tournament	noun
towards	preposition
towel	noun
tower	noun
town	noun
toxic	adjective
toy	noun
toy	adjective
trace	noun
trace	verb
track	noun
track	verb
trade	noun
trade	verb
trademark	noun
trading	noun
tradition	noun
traditional	adjective
traffic	noun
tragedy	noun
tragic	adjective
trail	noun
trail	verb
trailer	noun
train	noun
train	verb
trainer	noun
training	noun
trait	noun
transaction	noun
transcript	noun
transfer	noun
transfer	verb
transform	verb
transformation	noun
transit	noun
transition	noun
translate	verb
translation	noun
transmission	noun
transmit	verb
transparency	noun
transparent	adjective
transport	noun
transport	verb
transportation	noun
trap	noun
trap	verb
trauma	noun
travel	noun
travel	verb
traveller	noun
treasure	noun
treat	verb
treatment	noun
treaty	noun
tree	noun
tremendous	adjective
trend	noun
trial	noun
tribal	adjective
tribe	noun
tribunal	noun
tribute	noun
trick	noun
trick	verb
trigger	noun
trigger	verb
trillion	number
trio	noun
trip	noun
trip	verb
triumph	noun
troop	noun
trophy	noun
tropical	adjective
trouble	noun
trouble	verb
troubled	adjective
trousers	noun
truck	noun
true	adjective
truly	adverb
trust	noun
trust	verb
trustee	noun
truth	noun
try	noun
try	verb
tsunami	noun
tube	noun
Tuesday	noun
tuition	noun
tune	noun
tunnel	noun
turn	noun
turn	verb
turnout	noun
turnover	noun
TV	noun
twelve	number
twenty	number
twice	adverb
twin	adjective
twin	noun
twist	noun
twist	verb
two	number
type	noun
type	verb
typical	adjective
typically	adverb
tyre	noun
ugly	adjective
ultimate	adjective
ultimately	adverb
umbrella	noun
unable	adjective
unacceptable	adjective
uncertainty	noun
uncle	noun
uncomfortable	adjective
unconscious	adjective
under	preposition
under	adverb
undergo	verb
undergraduate	noun
underground	adjective
underground	adverb
underlying	adjective
undermine	verb
understand	verb
understanding	noun
undertake	verb
underwear	noun
undoubtedly	adverb
unemployed	adjective
unemployment	noun
unexpected	adjective
unfair	adjective
unfold	verb
unfortunate	adjective
unfortunately	adverb
unhappy	adjective
uniform	noun
unify	verb
union	noun
unique	adjective
unit	noun
unite	verb
united	adjective
unity	noun
universal	adjective
universe	noun
university	noun
unknown	adjective
unless	conjunction
unlike	preposition
unlikely	adjective
unnecessary	adjective
unpleasant	adjective
unprecedented	adjective
until	conjunction
until	preposition
unusual	adjective
unveil	verb
up	preposition
up	adverb
upcoming	adjective
update	noun
update	verb
upgrade	noun
upgrade	verb
uphold	verb
upon	preposition
upper	adjective
upset	adjective
upset	verb
upstairs	adjective
upstairs	adverb
upwards	adverb
urban	adjective
urge	verb
urgent	adjective
us	pronoun
usage	noun
use	noun
use	verb
used	adjective
used to	modal verb
useful	adjective
useless	adjective
user	noun
usual	adjective
usually	adverb
utility	noun
utilize	verb
utterly	adverb
vacation	noun
vacuum	noun
vague	adjective
valid	adjective
validity	noun
valley	noun
valuable	adjective
value	noun
value	verb
van	noun
vanish	verb
variable	adjective
variable	noun
variation	noun
varied	adjective
variety	noun
various	adjective
vary	verb
vast	adjective
vegetable	noun
vehicle	noun
vein	noun
venture	noun
venture	verb
venue	noun
verbal	adjective
verdict	noun
verify	verb
verse	noun
version	noun
versus	preposition
vertical	adjective
very	adjective
very	adverb
vessel	noun
veteran	noun
via	preposition
viable	adjective
vibrant	adjective
vice	noun
vicious	adjective
victim	noun
victory	noun
video	noun
view	noun
view	verb
viewer	noun
viewpoint	noun
village	noun
villager	noun
violate	verb
violation	noun
violence	noun
violent	adjective
virtual	adjective
virtue	noun
virus	noun
visa	noun
visible	adjective
vision	noun
visit	noun
visit	verb
visitor	noun
visual	adjective
vital	adjective
vitamin	noun
vocal	adjective
voice	noun
volume	noun
voluntary	adjective
volunteer	noun
volunteer	verb
vote	noun
vote	verb
voting	noun
vow	verb
vulnerability	noun
vulnerable	adjective
wage	noun
wait	noun
wait	verb
waiter	noun
wake	verb
walk	noun
walk	verb
wall	noun
wander	verb
want	verb
war	noun
ward	noun
warehouse	noun
warfare	noun
warm	adjective
warm	verb
warming	noun
warn	verb
warning	noun
warrant	noun
warrant	verb
warrior	noun
wash	noun
wash	verb
washing	noun
waste	adjective
waste	noun
waste	verb
watch	noun
watch	verb
water	noun
water	verb
wave	noun
wave	verb
way	noun
way	adverb
we	pronoun
weak	adjective
weaken	verb
weakness	noun
wealth	noun
wealthy	adjective
weapon	noun
wear	verb
weather	noun
weave	verb
web	noun
website	noun
wedding	noun
Wednesday	noun
weed	noun
week	noun
weekend	noun
weekly	adjective
weigh	verb
weight	noun
weird	adjective
welcome	adjective
welcome	noun
welcome	exclamation
welcome	verb
welfare	noun
well	adjective
well	noun
well	adverb
well	exclamation
well-being	noun
west	adjective
west	noun
west	adverb
western	adjective
wet	adjective
what	determiner
what	pronoun
whatever	determiner
whatever	pronoun
whatsoever	adverb
wheat	noun
wheel	noun
when	conjunction
when	adverb
when	pronoun
whenever	conjunction
where	adverb
where	conjunction
whereas	conjunction
whereby	adverb
wherever	conjunction
whether	conjunction
which	determiner
which	pronoun
while	conjunction
while	noun
whilst	conjunction
whip	verb
whisper	noun
whisper	verb
white	adjective
white	noun
who	pronoun
whoever	pronoun
whole	adjective
whole	noun
wholly	adverb
whom	pronoun
whose	determiner
whose	pronoun
why	adverb
wide	adjective
widely	adverb
widen	verb
widespread	adjective
widow	noun
width	noun
wife	noun
wild	adjective
wildlife	noun
will	modal verb
will	noun
willing	adjective
willingness	noun
win	noun
win	verb
wind	noun
wind	verb
window	noun
wine	noun
wing	noun
winner	noun
winter	noun
wipe	verb
wire	noun
wisdom	noun
wise	adjective
wish	noun
wish	verb
wit	noun
with	preposition
withdraw	verb
withdrawal	noun
within	preposition
without	preposition
witness	noun
witness	verb
woman	noun
wonder	noun
wonder	verb
wonderful	adjective
wood	noun
wooden	adjective
wool	noun
word	noun
work	noun
work	verb
worker	noun
workforce	noun
working	adjective
workout	noun
workplace	noun
workshop	noun
world	noun
worldwide	adjective
worldwide	adverb
worm	noun
worried	adjective
worry	noun
worry	verb
worse	adjective
worse	noun
worse	adverb
worship	noun
worship	verb
worst	adjective
worst	noun
worst	adverb
worth	adjective
worth	noun
worthwhile	adjective
worthy	adjective
would	modal verb
wound	noun
wound	verb
wow	exclamation
wrap	verb
wrist	noun
write	verb
writer	noun
writing	noun
written	adjective
wrong	adjective
wrong	noun
wrong	adverb
yard	noun
yeah	exclamation
year	noun
yell	verb
yellow	adjective
yellow	noun
yes	exclamation
yesterday	noun
yesterday	adverb
yet	conjunction
yet	adverb
yield	noun
yield	verb
you	pronoun
young	adjective
young	noun
youngster	noun
your	determiner
yours	pronoun
yourself	pronoun
youth	noun
zero	number
zone	noun
